LHR - 伦敦希思罗机场，伦敦，英国
AMS - 阿姆斯特丹史基浦机场，阿姆斯特丹，荷兰
IAD - 华盛顿杜勒斯国际机场，华盛顿特区，美国
FRA - 法兰克福机场，法兰克福，德国
LAX - 洛杉矶国际机场，洛杉矶，美国
SIN - 新加坡樟宜机场，新加坡
OSL - 奥斯陆加勒穆恩机场，奥斯陆，挪威
CDG - 巴黎戴高乐机场，巴黎，法国
HKG - 香港国际机场，香港，中国
SJC - 圣何塞国际机场，圣何塞，美国
SEA - 西雅图塔科马国际机场，西雅图，美国
ORD - 芝加哥奥黑尔国际机场，芝加哥，美国
IST - 伊斯坦布尔机场，伊斯坦布尔，土耳其
CPH - 哥本哈根凯斯楚普机场，哥本哈根，丹麦
BUF - 布法罗尼亚加拉国际机场，布法罗，美国
SYD - 悉尼金斯福德·史密斯机场，悉尼，澳大利亚
HEL - 赫尔辛基万塔机场，赫尔辛基，芬兰
ARN - 斯德哥尔摩阿兰达机场，斯德哥尔摩，瑞典
YUL - 蒙特利尔皮埃尔·埃利奥特·特鲁多国际机场，蒙特利尔，加拿大
TLL - 塔林机场，塔林，爱沙尼亚
YYZ - 多伦多皮尔逊国际机场，多伦多，加拿大
DFW - 达拉斯-沃斯堡国际机场，达拉斯，美国
NRT - 东京成田国际机场，东京，日本
LED - 圣彼得堡普尔科沃机场，圣彼得堡，俄罗斯
KIX - 关西国际机场，大阪，日本
VIE - 维也纳国际机场，维也纳，奥地利
WAW - 华沙肖邦机场，华沙，波兰
KWI - 科威特国际机场，科威特城，科威特
OTP - 布加勒斯特亨利·科安达国际机场，布加勒斯特，罗马尼亚
ICN - 仁川国际机场，首尔，韩国
DUB - 都柏林机场，都柏林，爱尔兰
MRS - 马赛普罗旺斯机场，马赛，法国
EWR - 纽瓦克自由国际机场，纽瓦克，美国
BOM - 孟买国际机场，孟买，印度
SDQ - 拉斯美利亚斯国际机场，圣多明各，多米尼加共和国
LCA - 拉纳卡国际机场，拉纳卡，塞浦路斯
DME - 莫斯科多莫杰多沃机场，莫斯科，俄罗斯
ALA - 阿拉木图国际机场，阿拉木图，哈萨克斯坦
ZRH - 苏黎世机场，苏黎世，瑞士
DUS - 杜塞尔多夫国际机场，杜塞尔多夫，德国
RIX - 里加国际机场，里加，拉脱维亚
TPE - 台北桃园国际机场，台北，中国台湾
PRG - 布拉格瓦茨拉夫·哈维尔国际机场，布拉格，捷克
ATL - 哈茨菲尔德-杰克逊亚特兰大国际机场，亚特兰大，美国
CGK - 雅加达苏加诺-哈达国际机场，雅加达，印度尼西亚
MXP - 米兰马尔彭萨机场，米兰，意大利
KEF - 凯夫拉维克国际机场，雷克雅未克，冰岛
PDX - 波特兰国际机场，波特兰，美国
TLV - 本·古里安国际机场，特拉维夫，以色列
SFO - 旧金山国际机场，旧金山，美国
DEN - 丹佛国际机场，丹佛，美国
KIV - 基希讷乌国际机场，基希讷乌，摩尔多瓦
BUD - 布达佩斯李斯特·费伦茨国际机场，布达佩斯，匈牙利
MEL - 墨尔本机场，墨尔本，澳大利亚
JNB - 奥利弗·坦博国际机场，约翰内斯堡，南非
HFA - 海法机场，海法，以色列
VNO - 维尔纽斯国际机场，维尔纽斯，立陶宛
SCL - 圣地亚哥阿图罗·梅里诺·贝尼特斯国际机场，圣地亚哥，智利
MAD - 马德里-巴拉哈斯机场，马德里，西班牙
BOS - 洛根国际机场，波士顿，美国
KUL - 吉隆坡国际机场，吉隆坡，马来西亚
RUH - 利雅得哈立德国王国际机场，利雅得，沙特阿拉伯
GVA - 日内瓦国际机场，日内瓦，瑞士